##########
# 0 #1 SS#
#   #    #
#   #    #
##2##    #
#      3 #
#####    #
# 5 #    #
#   4    #
##v#######