####^####
#### ####
###   ###
###YOU###
## WIN ##
##     ##
#   S   #
#       #
#########